111111111111
1PC000X000E1
111111111111
