11111111
10C00001
100C0001
10000001
100E0001
10000001
1P000001
11111111
