111111111111
100000000X01
10000C000001
100E11100001
10000C100001
100011100001
101100011111
100C00P00001
100000000001
111111111111
