11111111111
1X0000000E1
1C001110001
10000C10001
100011100C1
10110001101
1000000P001
11111111111
