111111111111
1PC000000E01
111111111111
