11111111
10C00001
10000001
100E0001
10001001
1P000001
10000001
10000001
11111111
