1111111
10C0P01
100C001
1E00001
1111111
