11111111111
1P0CCCCC0E1
11111111111
