11111111111
100000000E1
1C001110001
10000C10001
100011100C1
10110001101
1000000P001
1CCC111CCC1
1CCC1X1CCC1
1CCC111CCC1
1CCC000CCC1
1CCC111CCC1
1CCC101CCC1
1CCC101CCC1
1CCC111CCC1
10000000001
11111111111
