11111111111
10000000001
1C001110001
10000C10001
100011100C1
10110001101
1000000P001
10000000001
10000000001
1000X0X0001
1000X0X0001
1000X0X0001
1000X0X0001
1000XEX0001
10000000001
10000000001
11111111111
