111111
10C0P1
100C01
1E0001
111111